00000000000000000000
00000000000000000000
00000000000000000000
00000000000000000000
00000000011100000000
00000000014100000000
00000011113110000000
00000014235211000000
00000011132341000000
00000000121111000000
00000000141000000000
00000000111000000000
00000000000000000000
00000000000000000000
00000000000000000000
00000000000000000000
00000000000000000000
00000000000000000000
00000000000000000000
00000000000000000000